1 1 1 1 1 1 1 1 1
1 23 15 0 0 0 0 0 1
1 0 0 0 0 0 0 0 1
1 0 65 0 25 0 34 0 1
1 0 0 0 0 0 13 0 1
1 0 40 0 0 0 0 53 1
1 0 0 41 0 54 0 0 1
1 64 0 0 0 0 0 63 1
1 1 1 1 1 1 1 1 1
